{
    "template": "map",

    "map_key": {
        "F":    "terrain_forest",
        "G":    "terrain_grass" },
    "map_tiles":  [
        "GGGFFFFFFFFFFFFFFFFFFFFFF",
        "FGGGFFFFFFFFFFFFFFFFFFFFF",
        "FFGGGGGGFFFFFFFFFFGFFFFFF",
        "FFGGGGGFFFFFFFFFFGGFFFFFF",
        "FGGGGGFFFFFFFFFFGGGGFFFFF",
        "FFGGGGGFFFFFFFFFFGGGFFFFF",
        "FFFGGGGGFFFFFFFFFFGGGGFFF",
        "FFGGGGGGGFFFFFFFFGGGGFFFF",
        "FGGGGGGGGGGFFFFFGGGFFFFFF",
        "GGGGGGGGGGGGFFFGGGFFFFFFF",
        "GGGGGGGGGFFFFGGGGFFFFFFFF",
        "GGGGGGGGFFFFGGGFFFFFFFFFF",
        "GGGGGGGGGFGGGGFFFFFFFFFFF",
        "GGGGGGGGGGGGGGGFFFFFFFFFF",
        "GGGGFFFFFFFFGGGGFFFFFFFFF",
        "GGGFFFFFFFFFFFGGGGFFFFFFF",
        "GFFFFFFFFFFFFFFFFGGFFFFFF",
        "FFFFFFFFFFFFFFFFFFFFFFFFF",
        "FFFFFFFFFFFFFFFFFFFFFFFFF" ]
}
